 
 
 
                                     ┌─────────────────┐
                                     │.................│
                                     │.....1π1π1π1.....│
                                     │.................│
                                     ├─░░─┬───────┬─░░─┤
                                     │....│,♣,,,,,│....│
                                     │....│,,,~~♣,│....│
                                     │.....,,~~~,,.....│
                                     │....│,♣,~,,,│....│
                                     │....│,,,,,,,│....│
                                     ├─░░─┴───────┴─░░─┤
                                     │.................│
                                     │......0000.......│
                                     └─────────────────┘


