META name:Sides col:-,'|_ type:CTF author:InfernalMeep version:1 width:80 height:20 spaces:collide spawns:44,11
      ,-----,                   ,--,       ,--,                     ,-----,    
      |.....| ###################..|       |..##################### |.....|    
      |.....| #               # '--'       '--' #                 # |.....|    
      |.....'-#------------,  #                 #    ,------------#-'.....|    
      |....................|  #                 #    |....................|    
      |..,--,..,--,..,--,..|  #                 #    |..,--,..,--,..,--,..|    
      |..|  |..|  |..|  |..|  #                 #    |..|  |..|  |..|  |..|    
      |..'--'..'--'..'--'..'--#----,         ,--#----'..'--'..'--'..'--'..|    
      |............................'---------'............................|    
      '--,.............................................................,--'    
      ,--'.............................................................'--,    
      |............................,---------,............................|    
      |..,--,..,--,..,--,..,--#----'         '--#----,..,--,..,--,..,--,..|    
      |..|  |..|  |..|  |..|  #                 #    |..|  |..|  |..|  |..|    
      |..'--'..'--'..'--'..|  #                 #    |..'--'..'--'..'--'..|    
      |....................|  #                 #    |....................|    
      |.....,-#------------'  #                 #    '------------#-,.....|    
      |.....| #               # ,--,       ,--, #                 # |.....|    
      |.....| ###################..|       |..##################### |.....|    
      '-----'                   '--'       '--'                     '-----'    