                                                                               
                       ▲▲▲▲≈≈≈▲.▲..▲.▲.▲▲.▲▲▲.▲.▲▲▲▲▲▲.▲                       
                       ▲▲..▲≈≈≈▲.▲...▲.▲.▲▲▲.▲.▲▲▲...▲▲▲                       
                       .▲▲▲..≈≈≈≈≈≈≈≈≈≈.............▲▲▲.                       
                       .▲............≈≈≈≈.....▲......▲.▲                       
                       ▲...............≈≈≈............▲▲                       
                       ▲▲........▲....≈≈≈.....▲........▲                       
                       ▲▲...........≈≈≈..........▲.....▲                       
                       ▲▲....▲.....###....▲............▲                       
                       ▲..........≈≈≈.......▲...▲▲..▲..▲                       
                       ▲▲........≈≈≈................▲..▲                       
                       ▲▲....▲....≈≈≈........▲......▲..▲                       
                       ▲....▲.....≈≈≈....▲▲.......▲....▲                       
                       ▲▲..........###...........▲.....▲                       
                       ▲▲.......▲...≈≈≈.......▲........▲                       
                       ▲▲...▲.▲......≈≈≈.........▲▲...▲▲                       
                       ▲▲..........▲..≈≈≈...........▲▲▲▲                       
                       ▲▲▲▲.....▲..▲..≈≈≈........▲▲▲..▲.                       
                       ▲.▲.▲▲▲....▲▲....≈≈≈.▲.▲▲▲▲..▲.▲▲                       
                       ▲▲..▲.▲▲▲▲▲▲..▲▲▲▲.≈≈≈.▲....▲▲..▲                       