             ┌────┐      ┌────┐                  ######################    ┌──┐ 
┌──────┐     |....#####  |....|                  #                    ######..| 
|......|     └────┘   #  └─┐..|                ┌─#─────────┐          #    └──┘ 
|......└────┐         # ┌──┘..└───┐            |...........|          #         
|...........|         # |.........|            |...┌────┐..|          #         
└───────┐...└─────────#─┘.........└──┐         |...└────┘..└───┐      #         
        └─┐..........................###########...............|    ┌─#─┐       
          └─┐...┌──┐.........┌───────┘ #       |...┌─────────┐.|    |...|       
┌───┐    ┌──┘...└──┘.........|         ######──┘...└─────────┘.└────┘...|       
|....####....................|              #...........................|       
|....####....................|              #...........................|       
└───┘    └──┐...┌──┐.........|         ######──┐...┌─────────┐.┌────┐...|       
          ┌─┘...└──┘.........└───────┐ #       |...└─────────┘.|    |...|       
        ┌─┘..........................###########...............|    └─#─┘       
┌───────┘...┌─────────#─┐.........┌──┘         |...┌────┐..┌───┘      #         
|...........|         # |.........|            |...└────┘..|          #         
|......┌────┘         # └──┐..┌───┘            |...........|          #         
|......|     ┌────┐   #  ┌─┘..|                └─#─────────┘          #    ┌──┐ 
└──────┘     |....#####  |....|                  #                    ######..| 
             └────┘      └────┘                  ######################    └──┘ 